1111111111111111
100P110010011001
1000100011000001
1000100000C00001
1000010E00000001
1000110110000001
1111111111111111
