11111111111111
100P0100100111
10001000110001
1000100000C001
1000000E000001
10001101100001
11111111111111
