11111111111111111111111111111111111111111111111111111111111111111111111111111111111111111111111111111111111111
100P1100100110000000000000000000000000000000000000000000000000000000000000000000000000000000000000000000000001
10001000110000000000000000000000000000000000000000000000000000000000000000000000000000000000000000000000000001
1000100000C000010000000000000000000000000000000000000000000000000000000000000000000000000000000000000000000001
1000000E000000010000000000000010000000000000000000000000000000000000000000000000000000000000000000000000000001
10001101100000011111111111111000000000000000000000000000000000000000010000000000000000000001000000000000000011
11111111111111111111111111111111111111111111111111111111111111111111111111111111111111111111111111111111111111
