1111111111111111111111
100P110010011000000001
1000100011000000000001
1000100000C00001000001
1000000E00000001000001
1000110110000001111111
1111111111111111111111
