111111111111111111111111111111111111111111
100P11001001100000000000000000000000000001
100010001100000000000000000000000000000001
1000100000C0000100000000000000000000000001
1000000E0000000100000000000000100000000001
100011011000000111111111111110000000000001
111111111111111111111111111111111111111111
